10.ox
o..o...o..
..o.......
.........o
.....o..o.
.........o
..o....oo.
......x...
oo.......o
.o........
o.........
