1-0.ox
o.....o...
..oo......
..........
..........
..........
..........
o.........
o..o......
........oo
oo......oo
